111111111111111
10010000000C111
100001111100111
1P0011E00000111
111111111111111