1111111111111111111111111111111111
10000E00N00000C00000C0000000000011
1N000000000000C00000C000000000P011
101001010010000010100100000001N101
1010010010101010001001000E00010101
100000000C00CN0000N000000000000001
1111111111111111111111111111111111