1111111111111111111111111111111111
10000000N00000C00000C0000000000011
1010010100100000101001000000010101
1P10010010101010001001000E00010101
100000000C00C0000000000000000000C1
1111111111111111111111111111111111