111111111111111
1001C00000P1111
100001111100111
1E001100000C111
111111111111111