1111111111111111111111111111111111
1N000E0N000000C00000C000N000000001
1N0000N00010000CN0000C000000000001
1010010100100000101001N00000010101
101001N01010101N001001000E00010011
1P0000000C00CN0N00000N000100000011
1111111111111111111111111111111111